XXXXXXXXXXXXXXXXXXXXXXXXXXXXXXXXXXXXXXX
X X XXX            X            X     X
X X     XXXX XXXXXXXXXXXXXXXXXX XX XXXX
X XXX X X  X    XXXXXXXX X      X   X X
X  X  XXXX X XX  X       X  XXXXX XXX X
X XXX      X  X  X XXXXXXX      X XXX X
X   XX X  XX XX  X X        XXXXX X   X
XXX X  XX XXXXXX     XXXXXX XX  X X XXX
X X X  X      X  XXX X          X X X X
X X X XXXXXXXXX XX XXXXXXXX   X X X X X
X   X X  XXX     X   X  X XXX XXX X X X
X X       X  XX         X         X   X
X XXXXXXXXXXXXXXXXXXXXXXXXXXXXXXXXXXX X
X   X     XXXX X    XXX   X X X X  X  X
X X X XXX    X X XX   X X X       XX XX
X X X   X XX X X X  X XXX X XXXXX X  XX
X X   XXX  X     X XX  X       XX XX  X
X X X X XX XXXXXXX X  XXXX XX  X  XXX X
X X X X  X     X X XX  X   X  XXX X   X
X XXXXXX XXX XXX X  XX X XXX XXX  X XXX
X    PXX     X   XX  X     X X   XX   X
XXXXXXXXXXXX X XXXXX XXXXXXXXXX XXXX  X
X                 X         X       S X
XXXXXXXXXXXXXXXXXXXXXXXXXXXXXXXXXXXXXXX