666666666666666666666666666666666666666
616066600000000000061000000000006000000
606000006666266666666666666666606606666
606660606006000066666666060000002000006
600600666606066006000000060066666066606
606660000006006006066666660000006066606
600066060066066006060000000066666060006
666060066066666600000666666066006060666
606060060000006006660610000000006060606
606060666666666066066666666000606060606
600060600666000006000600606660666060606
606000000060066000000000600000000060006
606666660206666662666666606666666666606
600060000066660600006660006060606000006
606060666000060606600060606000000066066
606060006066060606006066606066666060066
606000666006000006066016000000066066006
606060606606666666060066660660060066606
606060600600000606066006000600666060006
606266660666066606006606266606660060666
600001660000060006600600000606000660006
666666666666060666660666666666606666006
000000000000000000600000000000000000216
666666666666666666666666666666666666666
