666666666666666666666666666666666666666
600000000000000000000000000000000000000
600000000000000000000000000000000000006
600000000000000000000000000000000000006
600000000000000000000000000000000000006
600000000000000000000000000000000000006
600000000000000000000000000000000000006
600000000000000000000000000000000000006
600000000000000000000000000000000000006
600000000000000000000000000000000000006
600000000000000000000000000000000000006
600000000000000000000000000000000000006
606666666666666666666666666666666666006
600000000000000000000000000000000000006
600000000000000000000000000000000000006
600000000000000000000000000000000000006
600000000000000000000000000000000000006
600000000000000000000000000000000000006
600000000000000000000000000000000000006
600000000000000000000000000000000000006
600000000000000000000000000000000000006
600000000000000000000000000000000000006
000000000000000000000000000000000000006
666666666666666666666666666666666666666


