666666666666666666666666666666666666666
600000000000000000000000000000000000000
600060000060066666666666666666666666606
600600606600000066666666000000000000606
600600666600000006000600060000006000606
600600000006006006000606000000000666606
606006000060060006000000000060000060006
600060000060000000000600000006000060666
600000060000006000660006000000000060606
606060600000600006006600000000600060606
600000060000000006000606000000060060606
600000000060006000000000600000000060006
606666666666666666666666666666666666606
600006000600000600006000000000000006006
600000666006000600000060000000000006066
606060000600000606006006606066660060066
606060006000060600060006000000600600006
606060000606006000060006600600000066606
600660600600000060006060000060600060006
606666600000066000000000066606000060666
600001600000060006600000000006000060006
666666666666060666660666666666606666006
000000000000000000600000000060000000216
666666666666666666666666666666666666666


