666666666666666666666666666666666666666
600000000000000000000000000000000000000
600060000060066666666666666666666666666
600600606600000066666666000000000000606
600600666600000006000600060000006000606
600600000006006006000606000000000666606
606006000060060006000000000060000060006
600060000060000000000600000006000060666
600000060000006000660006000000000060606
606060600000600006006600000000600060606
600000060000000006000606000000060060606
600000000060006000000000600000000060006
606666666666666666666666666666666666606
600060000066660600006660006060606006006
606060666000060606600060606000000066066
606060006066060606006066606066666060066
606000666006000006066006000000066066006
606060606606666666060066660660060066606
606060600600000606066006000600666060006
606666660666066606006606066606660060666
600001660000060006600600000606600660006
666666666666060666660666666666606666006
000000000000000000600000000060000000216
666666666666666666666666666666666666666


