666666666666666666666666666666666666666
600000000000000000000000000000000000000
600000000000000000000000000000000000006
600000000000000000000000000000000000006
600000000000000000000000000000000000006
600000000000000000000000000000000000006
600000000000000000000000000000000000006
600000000000000000000000000000000000006
600000000002222222222222222200000000006
600000000000000000000000000000000000006
600000000000000000000000000000000000006
600000000000000000000000000000000000006
606666666666666666666666666666666666006
600000000000000000000000000000000000006
600000000000000000000000000000000000006
600000000000000000001000000000000000006
600000000000000000000000000000000000006
600000000000000000000000000000000000006
600000000000000000000000000000000000006
600000000000000000000000000000000000006
600000000000000000006666666660000000006
600006666666666666666666660000000000006
000000000000000000000000000000000000006
666666666666666666666666666666666666666


